name,age,nationality,team,mascot,position,games_played,goals,assists,points
Brady Austin,24,CAN,BUF,sabres,D,5,0,0,0
Justin Bailey,22,USA,BUF,sabres,RW,32,2,2,4
Nicholas Baptiste,22,CAN,BUF,sabres,RW,14,3,1,4
Noel Acciari,26,USA,BOS,bruins,C,29,2,3,5
Zach Bogosian,27,USA,BUF,sabres,D,56,2,9,11
Erik Burgdoerfer,29,USA,BUF,sabres,D,2,0,0,0
William Carrier,23,CAN,BUF,sabres,LW,41,5,3,8
Nicolas Deslauriers,26,CAN,BUF,sabres,LW,42,0,2,2
Jack Eichel,21,USA,BUF,sabres,C,61,24,33,57
Tyler Ennis,28,CAN,BUF,sabres,LW/C/RW,51,5,8,13
Justin Falk,29,CAN,BUF,sabres,D,52,0,8,8
Hudson Fasching,22,USA,BUF,sabres,RW,10,0,1,1
Taylor Fedun,29,CAN,BUF,sabres,D,27,0,7,7
Marcus Foligno,26,USA,BUF,sabres,LW,80,13,10,23
Cody Franson,30,CAN,BUF,sabres,D,68,3,16,19
Brian Gionta,38,USA,BUF,sabres,RW,82,15,20,35
Zemgus Girgensons,23,LVA,BUF,sabres,C/LW,75,7,9,16
Josh Gorges,33,CAN,BUF,sabres,D,66,1,5,6
Brendan Guhle,20,CAN,BUF,sabres,D,3,0,0,0
David Backes,33,USA,BOS,bruins,RW/C,74,17,21,38
Evander Kane,26,CAN,BUF,sabres,LW,70,28,15,43
Dmitry Kulikov,27,RUS,BUF,sabres,D,47,2,3,5
Johan Larsson,25,SWE,BUF,sabres,C/LW,36,6,5,11
Sean Malone,22,USA,BUF,sabres,C,1,0,0,0
Jake McCabe,24,USA,BUF,sabres,D,76,3,17,20
Matt Moulson,34,CAN,BUF,sabres,LW,81,14,18,32
Casey Nelson,25,USA,BUF,sabres,D,11,0,0,0
Alex Nylander,19,CAN,BUF,sabres,RW/LW,4,0,1,1
Cal O'Reilly,31,CAN,BUF,sabres,C,11,0,1,1
Ryan O'Reilly,26,CAN,BUF,sabres,C/LW/RW,72,20,35,55
Kyle Okposo,29,USA,BUF,sabres,RW,65,19,26,45
Sam Reinhart,22,CAN,BUF,sabres,C,79,17,30,47
Rasmus Ristolainen,23,FIN,BUF,sabres,D,79,6,39,45
Evan Rodrigues,24,CAN,BUF,sabres,LW/C,30,4,2,6
Cole Schneider,27,USA,BUF,sabres,LW/RW,4,0,1,1
C.J. Smith,23,USA,BUF,sabres,LW/RW,2,0,1,1
Derek Grant,27,CAN,BUF/NSH,sabres,C,46,0,4,4
Sebastian Aho,20,FIN,CAR,hurricanes,RW/LW,82,24,25,49
Bryan Bickell,31,CAN,CAR,hurricanes,LW,11,1,0,1
Patrick Brown,25,USA,CAR,hurricanes,C,14,0,0,0
Matt Beleskey,29,CAN,BOS,bruins,LW,49,3,5,8
Klas Dahlbeck,26,SWE,CAR,hurricanes,D,43,2,4,6
Phillip Di Giuseppe,24,CAN,CAR,hurricanes,LW,36,1,6,7
Justin Faulk,25,USA,CAR,hurricanes,D,75,17,20,37
Martin Frk,24,CZE,CAR,hurricanes,RW,2,0,0,0
Noah Hanifin,20,USA,CAR,hurricanes,D,81,4,25,29
Elias Lindholm,23,SWE,CAR,hurricanes,C/RW,72,11,34,45
Patrice Bergeron,32,CAN,BOS,bruins,C,79,21,32,53
Jay McClement,34,CAN,CAR,hurricanes,C,65,5,3,8
Brock McGinn,23,CAN,CAR,hurricanes,LW,57,7,9,16
Ryan Murphy,24,CAN,CAR,hurricanes,D,27,0,2,2
Jakub Nakladal,30,CZE,CAR,hurricanes,D,3,0,0,0
Andrej Nestrasil,26,CZE,CAR,hurricanes,C/RW/LW,19,1,4,5
Kevin Bieksa,36,CAN,ANA,ducks,D,81,3,11,14
Joakim Nordstrom,25,SWE,CAR,hurricanes,LW/C,82,7,5,12
Brett Pesce,23,USA,CAR,hurricanes,D,82,2,18,20
Andrew Poturalski,23,USA,CAR,hurricanes,C,2,0,0,0
Victor Rask,24,SWE,CAR,hurricanes,C,82,16,29,45
Anton Blidh,22,SWE,BOS,bruins,LW,19,1,1,2
Derek Ryan,31,USA,CAR,hurricanes,C,67,11,18,29
Jeff Skinner,25,CAN,CAR,hurricanes,LW/C/RW,79,37,26,63
Jaccob Slavin,23,USA,CAR,hurricanes,D,82,5,29,34
Jordan Staal,29,CAN,CAR,hurricanes,C/LW,75,16,29,45
Jared Boll,31,USA,ANA,ducks,RW,51,0,3,3
Lee Stempniak,34,USA,CAR,hurricanes,RW,82,16,24,40
Matt Tennyson,27,USA,CAR,hurricanes,D,45,0,6,6
Teuvo Teravainen,23,FIN,CAR,hurricanes,LW/C/RW,81,15,27,42
Sergey Tolchinsky,22,RUS,CAR,hurricanes,LW,2,0,1,1
Lucas Wallmark,22,SWE,CAR,hurricanes,C,8,0,2,2
Valentin Zykov,22,RUS,CAR,hurricanes,LW,2,1,0,1
Viktor Stalberg,31,SWE,CAR/OTT,hurricanes,LW/RW,75,11,5,16
Ron Hainsey,36,USA,CAR/PIT,hurricanes,D,72,4,13,17
Ty Rattie,24,CAN,CAR/STL,hurricanes,RW,9,0,2,2
Josh Anderson,23,CAN,CBJ,bluejackets,RW,78,17,12,29
Cam Atkinson,28,USA,CBJ,bluejackets,RW,82,35,27,62
Oliver Bjorkstrand,22,DNK,CBJ,bluejackets,RW,26,6,7,13
Matt Calvert,28,CAN,CBJ,bluejackets,LW,65,10,5,15
Gabriel Carlsson,20,SWE,CBJ,bluejackets,D,2,0,1,1
Brandon Dubinsky,31,USA,CBJ,bluejackets,C/LW,80,12,29,41
Nick Foligno,30,USA,CBJ,bluejackets,LW/RW,79,26,25,51
Sam Gagner,28,CAN,CBJ,bluejackets,C/RW,81,18,32,50
Markus Hannikainen,24,FIN,CBJ,bluejackets,LW,10,1,1,2
Scott Harrington,24,CAN,CBJ,bluejackets,D,22,1,2,3
Scott Hartnell,35,CAN,CBJ,bluejackets,LW,78,13,24,37
Boone Jenner,24,CAN,CBJ,bluejackets,C/LW,82,18,16,34
Jack Johnson,30,USA,CBJ,bluejackets,D,82,5,18,23
Seth Jones,23,USA,CBJ,bluejackets,D,75,12,30,42
William Karlsson,24,SWE,CBJ,bluejackets,C,81,6,19,25
Sonny Milano,21,USA,CBJ,bluejackets,LW,4,0,0,0
Ryan Murray,24,CAN,CBJ,bluejackets,D,60,2,9,11
Alex Burmistrov,26,RUS,ARI/WPG,coyotes,C/RW,49,5,11,16
Markus Nutivaara,23,FIN,CBJ,bluejackets,D,66,2,5,7
Brandon Saad,25,USA,CBJ,bluejackets,LW/RW,82,24,29,53
David Savard,27,CAN,CBJ,bluejackets,D,74,6,17,23
Lukas Sedlak,24,CZE,CBJ,bluejackets,C/LW,62,7,6,13
T.J. Tynan,25,USA,CBJ,bluejackets,C/RW,3,0,0,0
Alex Wennberg,23,SWE,CBJ,bluejackets,C,80,13,46,59
Zach Werenski,20,USA,CBJ,bluejackets,D,78,11,36,47
Lauri Korpikoski,31,FIN,CBJ/DAL,bluejackets,LW/RW,69,8,12,20
Dalton Prout,27,CAN,CBJ/N.J,bluejackets,D,29,0,6,6
Kyle Quincey,32,CAN,CBJ/N.J,bluejackets,D,73,6,9,15
Rasmus Andersson,21,SWE,CGY,flames,D,1,0,0,0
Mikael Backlund,28,SWE,CGY,flames,C,81,22,31,53
Matt Bartkowski,29,USA,CGY,flames,D,24,1,1,2
Sam Bennett,21,CAN,CGY,flames,C,81,13,13,26
Brandon Carlo,21,USA,BOS,bruins,D,82,6,10,16
Lance Bouma,27,CAN,CGY,flames,C/LW/RW,61,3,4,7
T.J. Brodie,27,CAN,CGY,flames,D,82,6,30,36
Troy Brouwer,32,CAN,CGY,flames,RW,74,13,12,25
Alex Chiasson,27,CAN,CGY,flames,RW,81,12,12,24
Deryk Engelland,35,CAN,CGY,flames,D,81,4,12,16
Micheal Ferland,25,CAN,CGY,flames,LW/RW,76,15,10,25
Michael Frolik,29,CZE,CGY,flames,RW/C,82,17,27,44
Johnny Gaudreau,24,USA,CGY,flames,LW,72,18,43,61
Mark Giordano,34,CAN,CGY,flames,D,81,12,27,39
Peter Cehlarik,22,SVK,BOS,bruins,LW/RW,11,0,2,2
Nicklas Grossmann,32,SWE,CGY,flames,D,3,0,0,0
Dougie Hamilton,24,CAN,CGY,flames,D,81,13,37,50
Zdeno Chara,40,SVK,BOS,bruins,D,75,9,19,29
Freddie Hamilton,25,CAN,CGY,flames,C,26,2,0,2
Garnet Hathaway,26,USA,CGY,flames,RW,26,1,4,5
Mark Jankowski,23,CAN,CGY,flames,C,1,0,0,0
Brett Kulak,23,CAN,CGY,flames,D,21,0,3,3
Jakob Chychrun,19,USA,ARI,coyotes,D,68,7,13,20
Sean Monahan,23,CAN,CGY,flames,C,82,27,31,58
Hunter Shinkaruk,23,CAN,CGY,flames,C/LW,7,0,1,1
Matt Stajan,34,CAN,CGY,flames,C,81,6,17,23
Matthew Tkachuk,20,USA,CGY,flames,LW,76,13,35,48
Kris Versteeg,31,CAN,CGY,flames,RW/LW,69,15,22,37
Linden Vey,26,CAN,CGY,flames,RW/C,4,0,0,0
Andrew Cogliano,30,CAN,ANA,ducks,LW/C/RW,82,16,19,35
Dennis Wideman,34,CAN,CGY,flames,D,57,5,13,18
Tyler Wotherspoon,24,CAN,CGY,flames,D,4,0,0,0
Jyrki Jokipakka,26,FIN,CGY/OTT,flames,D,41,1,5,6
Curtis Lazar,22,CAN,CGY/OTT,flames,C/RW,37,1,3,4
Spencer Abbott,29,CAN,CHI,blackhawks,LW,1,0,0,0
Artem Anisimov,29,RUS,CHI,blackhawks,C/LW,64,22,23,45
Brian Campbell,38,CAN,CHI,blackhawks,D,80,5,12,17
Kevin Connauton,27,CAN,ARI,coyotes,D,24,0,1,1
Andrew Desjardins,31,CAN,CHI,blackhawks,LW/C,46,0,1,1
Gustav Forsling,21,SWE,CHI,blackhawks,D,38,2,3,5
Ryan Hartman,23,USA,CHI,blackhawks,LW/RW,76,19,12,31
John Hayden,22,USA,CHI,blackhawks,LW/RW/C,12,1,3,4
Vinnie Hinostroza,23,USA,CHI,blackhawks,LW/C,49,6,8,14
Niklas Hjalmarsson,30,SWE,CHI,blackhawks,D,73,5,13,18
Marian Hossa,38,SVK,CHI,blackhawks,RW,73,26,19,45
Patrick Kane,29,USA,CHI,blackhawks,RW/C,82,34,55,89
Duncan Keith,34,CAN,CHI,blackhawks,D,80,6,47,53
Joseph Cramarossa,25,CAN,ANA/VAN,ducks,C/LW,59,4,6,10
Michal Kempny,27,CZE,CHI,blackhawks,D,50,2,6,8
Lawson Crouse,20,CAN,ARI,coyotes,LW,72,5,7,12
Tanner Kero,25,USA,CHI,blackhawks,C/RW,47,6,10,16
Austin Czarnik,25,USA,BOS,bruins,C,49,5,8,13
Marcus Kruger,27,SWE,CHI,blackhawks,C,70,5,12,17
Tyler Motte,22,USA,CHI,blackhawks,LW/C,33,4,3,7
Artemi Panarin,26,RUS,CHI,blackhawks,LW/C,82,31,43,74
Richard Panik,26,SVK,CHI,blackhawks,RW/LW,82,22,22,44
Dennis Rasmussen,27,SWE,CHI,blackhawks,C,68,4,4,8
Laurent Dauphin,22,CAN,ARI,coyotes,C,24,2,1,3
Michal Rozsival,39,CZE,CHI,blackhawks,D,22,1,2,3
Nick Schmaltz,21,USA,CHI,blackhawks,C/LW,61,6,22,28
Brent Seabrook,32,CAN,CHI,blackhawks,D,79,3,36,39
Jonathan Toews,29,CAN,CHI,blackhawks,C,72,21,37,58
Anthony Deangelo,22,USA,ARI,coyotes,D,39,5,9,14
Jordin Tootoo,34,CAN,CHI,blackhawks,RW,50,2,1,3
Trevor van Riemsdyk,26,USA,CHI,blackhawks,D,58,5,11,16
Johnny Oduya,36,SWE,CHI/DAL,blackhawks,D,52,2,7,9
Tomas Jurco,25,SVK,CHI/DET,blackhawks,LW/RW,29,1,0,1
Tyson Barrie,26,CAN,COL,avalanche,D,74,7,31,38
Francois Beauchemin,37,CAN,COL,avalanche,D,81,5,13,18
Gabriel Bourque,27,CAN,COL,avalanche,LW/RW,6,0,0,0
Simon Despres,26,CAN,ANA,ducks,D,1,0,0,0
Rene Bourque,36,CAN,COL,avalanche,RW/LW,65,12,6,18
Joe Colborne,27,CAN,COL,avalanche,C/LW/RW,62,4,4,8
Blake Comeau,31,CAN,COL,avalanche,LW/RW,77,8,12,20
J.T. Compher,22,USA,COL,avalanche,LW/C,21,3,2,5
Shane Doan,41,CAN,ARI,coyotes,RW/LW,74,6,21,27
Max Domi,22,CAN,ARI,coyotes,LW/C,59,9,29,38
Matt Duchene,26,CAN,COL,avalanche,C/LW,77,18,23,41
Eric Gelinas,26,CAN,COL,avalanche,D,27,0,1,1
Cody Goloubef,28,CAN,COL,avalanche,D,33,0,5,5
A.J. Greer,21,CAN,COL,avalanche,LW,5,0,1,1
Mikhail Grigorenko,23,RUS,COL,avalanche,C,75,10,13,23
Rocco Grimaldi,24,USA,COL,avalanche,C,4,0,1,1
Samuel Henley,24,CAN,COL,avalanche,C/RW,1,1,0,1
Erik Johnson,29,USA,COL,avalanche,D,46,2,15,17
Tyson Jost,19,CAN,COL,avalanche,C/LW/RW,6,1,0,1
Gabriel Landeskog,25,SWE,COL,avalanche,LW,72,18,15,33
Anthony Duclair,22,CAN,ARI,coyotes,LW/RW,58,5,10,15
Anton Lindholm,23,SWE,COL,avalanche,D,12,0,0,0
Nathan MacKinnon,22,CAN,COL,avalanche,C/RW,82,16,37,53
John Mitchell,32,CAN,COL,avalanche,C,65,3,4,7
Christian Dvorak,21,USA,ARI,coyotes,C/LW,78,15,18,33
Mikko Rantanen,21,FIN,COL,avalanche,RW,75,20,18,38
Duncan Siemens,24,CAN,COL,avalanche,D,3,0,0,0
Patrick Eaves,33,CAN,ANA/DAL,ducks,RW/LW,79,32,19,51
Carl Soderberg,32,SWE,COL,avalanche,C/LW,80,6,8,14
Fedor Tyutin,34,RUS,COL,avalanche,D,69,1,12,13
Patrick Wiercioch,27,CAN,COL,avalanche,D,57,4,8,12
Nikita Zadorov,22,RUS,COL,avalanche,D,56,0,10,10
Jarome Iginla,40,CAN,COL/L.A,avalanche,RW,80,14,13,27
Sven Andrighetto,24,CHE,COL/MTL,avalanche,RW,46,7,17,24
Mark Barberio,27,CAN,COL/MTL,avalanche,D,60,2,11,13
Oliver Ekman-Larsson,26,SWE,ARI,coyotes,D,79,12,27,39
Andreas Martinsen,27,NOR,COL/MTL,avalanche,LW/C,64,3,4,7
Cody McLeod,33,CAN,COL/NSH,avalanche,LW/RW,59,5,1,6
Matt Nieto,25,USA,COL/S.J,avalanche,LW/RW,59,7,6,13
Ben Smith,29,USA,COL/TOR,avalanche,RW/C,40,2,2,4
Jamie Benn,28,CAN,DAL,stars,LW,77,26,43,69
Adam Cracknell,32,CAN,DAL,stars,RW/C,69,10,6,16
Jason Dickinson,22,CAN,DAL,stars,C,10,2,0,2
Justin Dowling,27,CAN,DAL,stars,C,9,0,2,2
Cody Eakin,26,CAN,DAL,stars,C,60,3,9,12
Remi Elie,22,CAN,DAL,stars,LW,18,1,6,7
Radek Faksa,23,CZE,DAL,stars,C,80,12,21,33
Denis Gurianov,20,RUS,DAL,stars,RW,1,0,0,0
Emerson Etem,25,USA,ANA,ducks,LW/RW,3,0,0,0
Dan Hamhuis,35,CAN,DAL,stars,D,79,1,15,16
Ales Hemsky,34,CZE,DAL,stars,RW,15,4,3,7
Julius Honka,22,FIN,DAL,stars,D,16,1,4,5
Jiri Hudler,33,CZE,DAL,stars,RW/LW,32,3,8,11
Stephen Johns,25,USA,DAL,stars,D,61,4,6,10
John Klingberg,25,SWE,DAL,stars,D,80,13,36,49
Esa Lindell,23,FIN,DAL,stars,D,73,6,12,18
Curtis McKenzie,26,CAN,DAL,stars,LW,53,6,10,16
Mark McNeill,24,CAN,DAL,stars,C/RW,1,0,0,0
Patrik Nemeth,25,SWE,DAL,stars,D,40,0,3,3
Jamie Oleksiak,25,CAN,DAL,stars,D,41,5,2,7
Brett Ritchie,24,CAN,DAL,stars,RW,78,16,8,24
Antoine Roussel,28,FRA,DAL,stars,LW,60,12,15,27
Tyler Seguin,25,CAN,DAL,stars,C/RW,82,26,46,72
Christian Fischer,20,USA,ARI,coyotes,RW,7,3,0,3
Patrick Sharp,36,CAN,DAL,stars,LW/RW/C,48,8,10,18
Devin Shore,23,CAN,DAL,stars,C,82,13,20,33
Gemel Smith,23,CAN,DAL,stars,C,17,3,3,6
Jason Spezza,34,CAN,DAL,stars,C,68,15,35,50
Jordie Benn,30,CAN,DAL/MTL,stars,D,71,4,13,17
Greg Pateryn,27,USA,DAL/MTL,stars,D,36,1,8,9
Jakob Forsbacka Karlsson,21,SWE,BOS,bruins,C,1,0,0,0
Justin Abdelkader,30,USA,DET,redwings,LW/RW,64,7,14,21
Andreas Athanasiou,23,CAN,DET,redwings,C,64,18,11,29
Cam Fowler,26,CAN,ANA,ducks,D,80,11,28,39
Tyler Bertuzzi,22,CAN,DET,redwings,LW,7,0,0,0
Mitch Callahan,26,USA,DET,redwings,RW,4,0,0,0
Danny DeKeyser,27,USA,DET,redwings,D,82,4,8,12
Jonathan Ericsson,33,SWE,DET,redwings,D,51,1,8,9
Luke Glendening,28,USA,DET,redwings,C/RW/LW,74,3,11,14
Mike Green,32,CAN,DET,redwings,D,72,14,22,36
Darren Helm,30,CAN,DET,redwings,C,50,8,9,17
Nick Jensen,27,USA,DET,redwings,D,49,4,9,13
Niklas Kronwall,36,SWE,DET,redwings,D,57,2,11,13
Ryan Garbutt,32,CAN,ANA,ducks,C/LW,27,2,1,3
Dylan Larkin,21,USA,DET,redwings,C/LW,80,17,15,32
Brian Lashoff,27,USA,DET,redwings,D,5,0,0,0
Tyler Gaudet,24,CAN,ARI,coyotes,C,4,0,1,1
Matt Lorito,27,CAN,DET,redwings,LW/RW,2,0,1,1
Anthony Mantha,23,CAN,DET,redwings,RW,60,17,19,36
Drew Miller,33,USA,DET,redwings,LW/RW,55,5,2,7
Frans Nielsen,33,DNK,DET,redwings,C,79,17,24,41
Tomas Nosek,25,CZE,DET,redwings,LW/C,11,1,0,1
Gustav Nyquist,28,SWE,DET,redwings,RW/C/LW,76,12,36,48
Xavier Ouellet,24,FRA,DET,redwings,D,66,3,9,12
Ryan Getzlaf,32,CAN,ANA,ducks,C,74,15,58,73
Dan Renouf,23,CAN,DET,redwings,D,1,0,0,0
Robbie Russo,24,USA,DET,redwings,D,19,0,0,0
Riley Sheahan,26,CAN,DET,redwings,C,80,2,11,13
Ryan Sproul,24,CAN,DET,redwings,D,27,1,6,7
Ben Street,30,CAN,DET,redwings,C,6,0,1,1
Evgeny Svechnikov,21,RUS,DET,redwings,RW/LW,2,0,0,0
Tomas Tatar,27,SVK,DET,redwings,LW/C/RW,82,25,21,46
Henrik Zetterberg,37,SWE,DET,redwings,LW/C,82,17,51,68
Thomas Vanek,33,AUT,DET/FLA,redwings,LW/RW,68,17,31,48
Steve Ott,35,CAN,DET/MTL,redwings,C/LW,53,3,4,7
Alex Goligoski,32,USA,ARI,coyotes,D,82,6,30,36
Brendan Smith,28,CAN,DET/NYR,redwings,D,51,3,6,9
Alexey Marchenko,25,RUS,DET/TOR,redwings,D,41,1,7,8
Matthew Benning,23,CAN,EDM,oilers,D,62,3,12,15
Drake Caggiula,23,CAN,EDM,oilers,LW/C,60,7,11,18
Leon Draisaitl,22,DEU,EDM,oilers,C,82,29,48,77
Jordan Eberle,27,CAN,EDM,oilers,RW/C,82,20,31,51
Mark Fayne,30,USA,EDM,oilers,D,4,0,2,2
Eric Gryba,29,CAN,EDM,oilers,D,40,2,4,6
Matt Hendricks,36,USA,EDM,oilers,LW/C,42,4,3,7
Zack Kassian,26,CAN,EDM,oilers,RW,79,7,17,24
Jujhar Khaira,23,CAN,EDM,oilers,LW,10,1,0,1
Oscar Klefbom,24,SWE,EDM,oilers,D,82,12,26,38
Anton Lander,26,SWE,EDM,oilers,C/LW/RW,22,1,3,4
Adam Larsson,25,SWE,EDM,oilers,D,79,4,15,19
Mark Letestu,32,CAN,EDM,oilers,C/RW,78,16,19,35
Milan Lucic,29,CAN,EDM,oilers,LW,82,23,27,50
Patrick Maroon,29,USA,EDM,oilers,LW,81,27,15,42
Connor McDavid,20,CAN,EDM,oilers,C,82,30,70,100
Ryan Nugent-Hopkins,24,CAN,EDM,oilers,C,82,18,25,43
Darnell Nurse,22,CAN,EDM,oilers,D,44,5,6,11
Jordan Oesterle,25,USA,EDM,oilers,D,2,0,0,0
Iiro Pakarinen,26,FIN,EDM,oilers,RW,14,2,2,4
Tyler Pitlick,26,USA,EDM,oilers,RW/C,31,8,3,11
Matt Grzelcyk,23,USA,BOS,bruins,D,2,0,0,0
Benoit Pouliot,31,CAN,EDM,oilers,LW,67,8,6,14
Jesse Puljujarvi,19,SWE,EDM,oilers,RW,28,1,7,8
Kris Russell,30,CAN,EDM,oilers,D,68,1,12,13
Andrej Sekera,31,SVK,EDM,oilers,D,80,8,27,35
Dillon Simpson,24,CAN,EDM,oilers,D,3,0,0,0
Anton Slepyshev,23,RUS,EDM,oilers,LW,41,4,6,10
Brandon Davidson,26,CAN,EDM/MTL,oilers,D,38,0,3,3
David Desharnais,31,CAN,EDM/MTL,oilers,C,49,6,8,14
Taylor Beck,26,CAN,EDM/NYR,oilers,LW,5,0,0,0
Aleksander Barkov,22,FIN,FLA,panthers,C,61,21,31,52
Nick Bjugstad,25,USA,FLA,panthers,C,54,7,7,14
Jason Demers,29,CAN,FLA,panthers,D,81,9,19,28
Aaron Ekblad,21,CAN,FLA,panthers,D,68,10,11,21
Shane Harper,28,USA,FLA,panthers,RW,14,2,1,3
Jonathan Huberdeau,24,CAN,FLA,panthers,LW/C,31,10,16,26
Jaromir Jagr,45,CZE,FLA,panthers,RW,82,16,30,46
Jussi Jokinen,34,FIN,FLA,panthers,LW/RW/C,69,11,17,28
Jakub Kindl,30,CZE,FLA,panthers,D,39,0,4,4
Derek MacKenzie,36,CAN,FLA,panthers,C/LW,82,6,10,16
Martin Hanzal,30,CZE,ARI/MIN,coyotes,C,71,20,19,39
Denis Malgin,20,CHE,FLA,panthers,C,47,6,4,10
Jonathan Marchessault,27,CAN,FLA,panthers,C,75,30,21,51
Michael Matheson,23,CAN,FLA,panthers,D,81,7,10,17
Jared McCann,21,CAN,FLA,panthers,C,29,1,6,7
Ian McCoshen,22,USA,FLA,panthers,D,3,0,1,1
Alex Petrovic,25,CAN,FLA,panthers,D,49,1,13,14
Mark Pysyk,25,CAN,FLA,panthers,D,82,4,13,17
Kyle Rau,25,USA,FLA,panthers,C,24,2,1,3
Jimmy Hayes,28,USA,BOS,bruins,RW,58,2,3,5
Colton Sceviour,28,CAN,FLA,panthers,C/RW,80,9,15,24
Reilly Smith,26,CAN,FLA,panthers,RW/C/LW,80,15,22,37
Paul Thompson,29,USA,FLA,panthers,RW,21,0,3,3
Danton Heinen,22,CAN,BOS,bruins,C,8,0,0,0
Shawn Thornton,40,CAN,FLA,panthers,LW,50,2,2,4
Vincent Trocheck,24,USA,FLA,panthers,C/RW,82,23,31,54
Mackenzie Weegar,23,CAN,FLA,panthers,D,3,0,0,0
Keith Yandle,31,USA,FLA,panthers,D,82,5,36,41
Steven Kampfer,29,USA,FLA/NYR,panthers,D,11,1,1,2
Dylan McIlrath,25,CAN,FLA/NYR,panthers,D,6,1,0,1
Greg McKegg,25,CAN,FLA/T.B,panthers,C,46,3,4,7
Seth Griffith,24,CAN,FLA/TOR,panthers,C/RW,24,0,5,5
Andy Andreoff,26,CAN,L.A,kings,LW/C,36,0,2,2
Jonny Brodzinski,24,USA,L.A,kings,C,6,0,2,2
Dustin Brown,33,USA,L.A,kings,RW/LW,80,14,22,36
Jeff Carter,32,CAN,L.A,kings,C/RW,82,32,34,66
Kyle Clifford,26,CAN,L.A,kings,LW/C,73,6,6,12
Peter Holland,26,CAN,ARI/TOR,coyotes,C,48,5,7,12
Korbinian Holzer,29,DEU,ANA,ducks,D,32,2,5,7
Drew Doughty,28,CAN,L.A,kings,D,82,12,32,44
Nic Dowd,27,USA,L.A,kings,C,70,6,16,22
Derek Forbort,25,USA,L.A,kings,D,82,2,16,18
Marian Gaborik,35,SVK,L.A,kings,RW,56,10,11,21
Tom Gilbert,34,USA,L.A,kings,D,18,1,4,5
Kevin Gravel,25,USA,L.A,kings,D,49,1,6,7
Matt Greene,34,USA,L.A,kings,D,26,1,1,2
Adrian Kempe,21,SWE,L.A,kings,LW/C,25,2,4,6
Anze Kopitar,30,SVN,L.A,kings,C,76,12,40,52
Paul Ladue,25,USA,L.A,kings,D,22,0,8,8
Trevor Lewis,30,USA,L.A,kings,C/RW/LW,82,12,12,24
Alec Martinez,30,USA,L.A,kings,D,82,9,30,39
Brayden McNabb,26,CAN,L.A,kings,D,49,2,2,4
Jake Muzzin,28,CAN,L.A,kings,D,82,9,19,28
Jordan Nolan,28,CAN,L.A,kings,C/LW/RW,46,4,4,8
Tanner Pearson,25,CAN,L.A,kings,LW,80,24,20,44
Teddy Purcell,32,CAN,L.A,kings,LW/RW,12,0,2,2
Devin Setoguchi,30,CAN,L.A,kings,RW,45,4,8,12
Nick Shore,25,USA,L.A,kings,C,70,6,11,17
Tyler Toffoli,25,CAN,L.A,kings,C/RW/LW,63,16,18,34
Dwight King,28,CAN,L.A/MTL,kings,LW/RW,80,9,7,16
Christoph Bertschy,23,CHE,MIN,wild,C,5,0,1,1
Jonas Brodin,24,SWE,MIN,wild,D,68,3,22,25
Patrick Cannone,31,USA,MIN,wild,C,3,0,0,0
Charlie Coyle,25,USA,MIN,wild,C/RW,82,18,38,56
Zac Dalpe,28,CAN,MIN,wild,C,9,1,2,3
Matt Dumba,23,CAN,MIN,wild,D,76,11,23,34
Joel Eriksson Ek,20,SWE,MIN,wild,C/RW/LW,15,3,4,7
Christian Folin,26,SWE,MIN,wild,D,51,2,6,8
Kurtis Gabriel,24,CAN,MIN,wild,RW,13,0,1,1
Mikael Granlund,25,FIN,MIN,wild,C,81,26,43,69
Tyler Graovac,24,CAN,MIN,wild,C,52,7,2,9
Erik Haula,26,FIN,MIN,wild,C/LW,72,15,11,26
Josh Jooris,27,CAN,ARI/NYR,coyotes,RW/C,54,4,8,12
Mikko Koivu,34,FIN,MIN,wild,C,80,18,40,58
Zack Mitchell,24,CAN,MIN,wild,RW,11,0,0,0
Nino Niederreiter,25,CHE,MIN,wild,RW,82,25,32,57
Gustav Olofsson,23,SWE,MIN,wild,D,13,0,3,3
Zach Parise,33,USA,MIN,wild,LW,69,19,23,42
Jason Pominville,35,CAN,MIN,wild,RW,78,13,34,47
Nate Prosser,31,USA,MIN,wild,D,39,2,5,7
Mike Reilly,24,USA,MIN,wild,D,17,1,0,1
Marco Scandella,27,CAN,MIN,wild,D,71,4,9,13
Jordan Schroeder,27,USA,MIN,wild,C/RW,37,6,7,13
Jared Spurgeon,28,CAN,MIN,wild,D,76,10,28,38
Eric Staal,33,CAN,MIN,wild,C,82,28,37,65
Chris Stewart,30,CAN,MIN,wild,RW/LW,79,13,8,21
Ryan Suter,32,USA,MIN,wild,D,82,9,31,40
Alex Tuch,21,USA,MIN,wild,RW,6,0,0,0
Ondrej Kase,22,CZE,ANA,ducks,RW,53,5,10,15
Jason Zucker,25,USA,MIN,wild,LW/RW,79,22,25,47
Nathan Beaulieu,25,CAN,MTL,canadians,D,74,4,24,28
Paul Byron,28,CAN,MTL,canadians,LW/C/RW,81,22,21,43
Clayton Keller,19,USA,ARI,coyotes,C/LW,3,0,2,2
Daniel Carr,26,CAN,MTL,canadians,LW,33,2,7,9
Phillip Danault,24,CAN,MTL,canadians,LW/C,82,13,27,40
Jacob De la Rose,22,SWE,MTL,canadians,LW,9,0,0,0
Nicolas Kerdiles,23,USA,ANA,ducks,LW,1,0,0,0
Alexei Emelin,31,RUS,MTL,canadians,D,76,2,8,10
Ryan Kesler,33,USA,ANA,ducks,C/RW,82,22,36,58
Bobby Farnham,28,USA,MTL,canadians,RW,3,0,0,0
Brian Flynn,29,USA,MTL,canadians,C/RW,51,6,4,10
Alex Galchenyuk,23,USA,MTL,canadians,C/LW,61,17,27,44
Brendan Gallagher,25,CAN,MTL,canadians,RW,64,10,19,29
Joel Hanley,26,CAN,MTL,canadians,D,7,0,0,0
Charles Hudon,23,CAN,MTL,canadians,LW,3,0,2,2
Ryan Johnston,25,CAN,MTL,canadians,D,7,0,0,0
Artturi Lehkonen,22,FIN,MTL,canadians,LW,73,18,10,28
Brett Lernout,22,CAN,MTL,canadians,D,2,0,0,0
Andrei Markov,39,RUS,MTL,canadians,D,62,6,30,36
Michael McCarron,22,USA,MTL,canadians,RW/C,31,1,4,5
Torrey Mitchell,32,CAN,MTL,canadians,C/RW,78,8,9,17
Max Pacioretty,29,USA,MTL,canadians,LW,81,35,32,67
Jeff Petry,30,USA,MTL,canadians,D,80,8,20,28
Kalle Kossila,24,FIN,ANA,ducks,LW/C,1,0,0,0
Tomas Plekanec,35,CZE,MTL,canadians,C,78,10,18,28
David Krejci,31,CZE,BOS,bruins,C,82,23,31,54
Alex Radulov,31,RUS,MTL,canadians,RW,76,18,36,54
Torey Krug,26,USA,BOS,bruins,D,81,8,43,51
Zach Redmond,29,USA,MTL,canadians,D,16,0,5,5
Nikita Scherbak,22,RUS,MTL,canadians,RW,3,1,0,1
Mikhail Sergachev,19,RUS,MTL,canadians,D,4,0,0,0
Andrew Shaw,26,CAN,MTL,canadians,C/LW/RW,68,12,17,29
Chris Terry,28,CAN,MTL,canadians,LW/RW,14,2,2,4
Shea Weber,32,CAN,MTL,canadians,D,78,17,25,42
Nikita Nesterov,24,RUS,MTL/T.B,canadians,D,48,4,13,17
Sean Kuraly,24,USA,BOS,bruins,C,8,0,1,1
Yohann Auvitu,28,FRA,N.J,devils,D/LW,25,2,2,4
Beau Bennett,26,USA,N.J,devils,RW/LW,65,8,11,19
Joseph Blandisi,23,CAN,N.J,devils,LW/C,27,3,6,9
Mike Cammalleri,35,CAN,N.J,devils,LW/C,61,10,21,31
Blake Coleman,26,USA,N.J,devils,C/LW,23,1,1,2
Luke Gazdic,28,CAN,N.J,devils,LW,11,0,0,0
Andy Greene,35,USA,N.J,devils,D,66,4,9,13
Taylor Hall,26,CAN,N.J,devils,LW/C,72,20,33,53
Seth Helgeson,27,USA,N.J,devils,D,9,1,0,1
Adam Henrique,27,CAN,N.J,devils,C,82,20,20,40
Jacob Josefson,26,SWE,N.J,devils,C/LW,38,1,9,10
Sergey Kalinin,26,RUS,N.J,devils,C/RW,43,2,2,4
Jacob Larsson,20,SWE,ANA,ducks,D,4,0,0,0
Michael Kapla,23,USA,N.J,devils,D,5,0,0,0
Nick Lappin,25,USA,N.J,devils,RW,43,4,3,7
Ben Lovejoy,33,USA,N.J,devils,D,82,1,6,7
Jon Merrill,25,USA,N.J,devils,D,51,1,5,6
John Moore,27,USA,N.J,devils,D,63,12,10,22
Kyle Palmieri,26,USA,N.J,devils,RW/C/LW,80,26,27,53
Blake Pietila,24,USA,N.J,devils,LW/C,10,0,1,1
John Quenneville,21,CAN,N.J,devils,C,12,1,3,4
Kevin Rooney,24,USA,N.J,devils,C,4,0,0,0
Steven Santini,22,USA,N.J,devils,D,38,2,5,7
Damon Severson,23,CAN,N.J,devils,D,80,3,28,31
Devante Smith-Pelly,25,CAN,N.J,devils,RW/C/LW,53,4,5,9
Blake Speers,20,CAN,N.J,devils,C,3,0,0,0
Karl Stollery,30,CAN,N.J,devils,D,11,0,3,3
Ben Thomson,24,CAN,N.J,devils,LW,3,0,0,0
John-Michael Liles,37,USA,BOS,bruins,D,36,0,5,5
Miles Wood,22,USA,N.J,devils,LW,60,8,9,17
Pavel Zacha,20,CZE,N.J,devils,C,70,8,16,24
Travis Zajac,32,CAN,N.J,devils,C,80,14,31,45
Vernon Fiddler,37,CAN,N.J/NSH,devils,C/LW,59,2,2,4
PA Parenteau,34,CAN,N.J/NSH,devils,RW,67,13,15,28
Hampus Lindholm,23,SWE,ANA,ducks,D,66,6,14,20
Reid Boucher,24,USA,N.J/NSH/VAN,devils,C/LW,39,6,4,10
Pontus Aberg,24,SWE,NSH,predators,LW,15,1,1,2
Viktor Arvidsson,24,SWE,NSH,predators,LW/RW,80,31,30,61
Cody Bass,30,CAN,NSH,predators,C,9,0,0,0
Anthony Bitetto,27,USA,NSH,predators,D,29,0,7,7
Matt Carle,33,USA,NSH,predators,D,6,0,1,1
Alex Carrier,21,CAN,NSH,predators,D,2,0,0,0
Mattias Ekholm,27,SWE,NSH,predators,D,82,3,20,23
Ryan Ellis,26,CAN,NSH,predators,D,71,16,22,38
Kevin Fiala,21,CHE,NSH,predators,LW,54,11,5,16
Mike Fisher,37,CAN,NSH,predators,C,72,18,24,42
Filip Forsberg,23,SWE,NSH,predators,LW/C/RW,82,31,27,58
Frederick Gaudreau,24,CAN,NSH,predators,C,9,0,1,1
Petter Granberg,25,SWE,NSH,predators,D,10,0,0,0
Matt Irwin,30,CAN,NSH,predators,D,74,3,11,14
Josh Manson,26,USA,ANA,ducks,D,82,5,12,17
Calle Jarnkrok,26,SWE,NSH,predators,C,81,15,16,31
Brad Marchand,29,CAN,BOS,bruins,LW/C,80,39,46,85
Ryan Johansen,25,CAN,NSH,predators,C/RW,82,14,47,61
Roman Josi,27,CHE,NSH,predators,D,72,12,37,49
Vladislav Kamenev,21,RUS,NSH,predators,LW/C,2,0,0,0
Mike Liambas,28,CAN,NSH,predators,LW,1,0,0,0
James Neal,30,CAN,NSH,predators,RW/LW,70,23,18,41
Adam Pardy,33,CAN,NSH,predators,D,4,0,0,0
Mike Ribeiro,37,CAN,NSH,predators,C,46,4,21,25
Miikka Salomaki,24,FIN,NSH,predators,RW,5,0,0,0
Colton Sissons,24,CAN,NSH,predators,C,58,8,2,10
Craig Smith,28,USA,NSH,predators,RW/LW/C,78,12,17,29
Jordan Martinook,25,CAN,ARI,coyotes,LW/C,77,11,14,25
Trevor Smith,32,CAN,NSH,predators,C/RW,1,0,0,0
P.K. Subban,28,CAN,NSH,predators,D,66,10,30,40
Austin Watson,25,USA,NSH,predators,LW,77,5,12,17
Yannick Weber,29,CHE,NSH,predators,D,73,1,7,8
Colin Wilson,28,USA,NSH,predators,LW/C,70,12,23,35
Jamie McBain,29,USA,ARI,coyotes,D,3,0,0,0
Harry Zolnierczyk,30,CAN,NSH,predators,LW,24,2,2,4
Brad Hunt,29,CAN,NSH/STL,predators,D,12,1,5,6
Josh Bailey,28,CAN,NYI,islanders,RW/LW/C,82,13,43,56
Mathew Barzal,20,CAN,NYI,islanders,C,2,0,0,0
Anthony Beauvillier,20,CAN,NYI,islanders,C/LW,66,9,15,24
Johnny Boychuk,33,CAN,NYI,islanders,D,66,6,17,23
Jason Chimera,38,CAN,NYI,islanders,LW/RW,82,20,13,33
Casey Cizikas,26,CAN,NYI,islanders,C,59,8,17,25
Cal Clutterbuck,30,CAN,NYI,islanders,RW,66,5,15,20
Calvin de Haan,26,CAN,NYI,islanders,D,82,5,20,25
Stephen Gionta,34,USA,NYI,islanders,RW/C,26,1,5,6
Jamie McGinn,29,CAN,ARI,coyotes,LW/RW,72,9,8,17
Travis Hamonic,27,CAN,NYI,islanders,D,49,3,11,14
Thomas Hickey,28,CAN,NYI,islanders,D,76,4,16,20
Joshua Ho-Sang,21,CAN,NYI,islanders,RW/C,21,4,6,10
Connor Jones,27,CAN,NYI,islanders,C/LW,4,0,0,0
Bracken Kearns,36,CAN,NYI,islanders,C,2,0,0,0
Nikolay Kulemin,31,RUS,NYI,islanders,LW/RW,72,12,11,23
Adam Mcquaid,31,CAN,BOS,bruins,D,77,2,8,10
Andrew Ladd,32,CAN,NYI,islanders,LW,78,23,8,31
Jaycob Megna,25,USA,ANA,ducks,D,1,0,0,0
Nick Leddy,26,USA,NYI,islanders,D,81,11,35,46
Anders Lee,27,USA,NYI,islanders,LW/C,81,34,18,52
Scott Mayfield,25,USA,NYI,islanders,D,25,2,7,9
Brock Nelson,26,USA,NYI,islanders,C/LW,81,20,25,45
Adam Pelech,23,CAN,NYI,islanders,D,44,3,7,10
Shane Prince,25,USA,NYI,islanders,LW/C,50,5,13,18
Zbynek Michalek,35,CZE,ARI,coyotes,D,3,0,0,0
Ryan Pulock,23,CAN,NYI,islanders,D,1,0,0,0
Colin Miller,25,CAN,BOS,bruins,D,61,6,7,13
Alan Quine,24,CAN,NYI,islanders,C,61,5,13,18
Dennis Seidenberg,36,DEU,NYI,islanders,D,73,5,17,22
Kevan Miller,30,USA,BOS,bruins,D,58,3,10,13
Ryan Strome,24,CAN,NYI,islanders,RW/C,69,13,17,30
John Tavares,27,CAN,NYI,islanders,C,77,28,38,66
Pavel Buchnevich,22,RUS,NYR,rangers,RW/LW,41,8,12,20
Adam Clendening,25,USA,NYR,rangers,D,31,2,9,11
Jesper Fast,26,SWE,NYR,rangers,RW/LW,68,6,15,21
Dan Girardi,33,CAN,NYR,rangers,D,63,4,11,15
Brandon Montour,23,CAN,ANA,ducks,D,27,2,4,6
Dominic Moore,37,CAN,BOS,bruins,C/LW,82,11,14,25
Tanner Glass,34,CAN,NYR,rangers,LW,11,1,1,2
Michael Grabner,30,AUT,NYR,rangers,RW,76,27,13,40
Kevin Hayes,25,USA,NYR,rangers,C/RW,76,17,32,49
Joe Morrow,25,CAN,BOS,bruins,D,17,0,1,1
Nick Holden,30,CAN,NYR,rangers,D,80,11,23,34
Marek Hrivik,26,SVK,NYR,rangers,LW/C/RW,16,0,2,2
Nicklas Jensen,24,DNK,NYR,rangers,RW/LW,7,0,0,0
Connor Murphy,24,USA,ARI,coyotes,D,77,2,15,17
Kevin Klein,33,CAN,NYR,rangers,D,60,3,11,14
Chris Kreider,26,USA,NYR,rangers,LW/C,75,28,25,53
Oscar Lindberg,26,SWE,NYR,rangers,C,65,8,12,20
Ryan McDonagh,28,USA,NYR,rangers,D,77,6,36,42
J.T. Miller,24,USA,NYR,rangers,LW/RW/C,82,22,34,56
Rick Nash,33,CAN,NYR,rangers,RW/LW,67,23,15,38
Cristoval Nieves,23,USA,NYR,rangers,C/LW,1,0,0,0
Riley Nash,28,CAN,BOS,bruins,C/RW,81,7,10,17
Brandon Pirri,26,CAN,NYR,rangers,RW/LW/C,60,8,10,18
Brady Skjei,23,USA,NYR,rangers,D,80,5,34,39
Marc Staal,30,CAN,NYR,rangers,D,72,3,7,10
Derek Stepan,27,USA,NYR,rangers,C,81,17,38,55
Jimmy Vesey,24,USA,NYR,rangers,LW,80,16,11,27
Mika Zibanejad,24,SWE,NYR,rangers,C/RW,56,14,23,37
Mats Zuccarello,30,NOR,NYR,rangers,RW/C/LW,80,15,44,59
Matt Puempel,24,CAN,NYR/OTT,rangers,LW,40,6,3,9
Casey Bailey,26,USA,OTT,senators,RW/C,7,0,0,0
Mike Blunden,31,CAN,OTT,senators,RW,2,0,0,0
Mark Borowiecki,28,CAN,OTT,senators,D,70,1,2,3
Derick Brassard,30,CAN,OTT,senators,C,81,14,25,39
Cody Ceci,24,CAN,OTT,senators,D,79,2,15,17
Stefan Noesen,24,USA,ANA/N.J,ducks,RW,44,8,2,10
Thomas Chabot,20,CAN,OTT,senators,D,1,0,0,0
Fredrik Claesson,25,SWE,OTT,senators,D,33,3,8,11
Chris Didomenico,28,CAN,OTT,senators,C/RW,3,0,0,0
Ryan Dzingel,25,USA,OTT,senators,LW/RW/C,81,14,18,32
Andreas Englund,21,SWE,OTT,senators,D,5,0,0,0
Ben Harpur,22,CAN,OTT,senators,D,6,0,0,0
Mike Hoffman,28,CAN,OTT,senators,LW/C,74,26,35,61
Erik Karlsson,27,SWE,OTT,senators,D,77,17,54,71
Chris Kelly,37,CAN,OTT,senators,C/LW,82,5,7,12
Clarke MacArthur,32,CAN,OTT,senators,LW,4,0,0,0
Max McCormick,25,USA,OTT,senators,RW/LW/C,7,0,0,0
Rob O'Gara,24,USA,BOS,bruins,D,3,0,0,0
Marc Methot,32,CAN,OTT,senators,D,68,0,12,12
Chris Neil,38,CAN,OTT,senators,RW,53,1,3,4
Jean-Gabriel Pageau,25,CAN,OTT,senators,C,82,12,21,33
Nick Paul,22,CAN,OTT,senators,LW/C,1,0,0,0
Dion Phaneuf,32,CAN,OTT,senators,D,81,9,21,30
Tom Pyatt,30,CAN,OTT,senators,LW/C,82,9,14,23
Buddy Robinson,26,USA,OTT,senators,RW,4,0,0,0
Bobby Ryan,30,USA,OTT,senators,RW/LW,62,13,12,25
Zack Smith,29,CAN,OTT,senators,C,74,16,16,32
Mark Stone,25,CAN,OTT,senators,RW,71,22,32,54
Kyle Turris,28,CAN,OTT,senators,C,78,27,28,55
Phil Varone,27,CAN,OTT,senators,C,7,0,0,0
Colin White,20,USA,OTT,senators,C/D,2,0,0,0
Chris Wideman,27,USA,OTT,senators,D,76,5,12,17
Tommy Wingels,29,USA,OTT/S.J,senators,C/RW/LW,73,7,5,12
Alex Burrows,36,CAN,OTT/VAN,senators,LW/RW,75,15,16,31
Pierre-Edouard Bellemare,32,FRA,PHI,flyers,LW/C,82,4,4,8
Nick Cousins,24,CAN,PHI,flyers,C/LW,60,6,10,16
Sean Couturier,25,USA,PHI,flyers,C,66,14,20,34
Michael Del Zotto,27,CAN,PHI,flyers,D,51,6,12,18
Claude Giroux,29,CAN,PHI,flyers,C/RW,82,14,44,58
Boyd Gordon,34,CAN,PHI,flyers,C/RW,13,1,0,1
Shayne Gostisbehere,24,USA,PHI,flyers,D,76,7,32,39
Radko Gudas,27,CZE,PHI,flyers,D,67,6,17,23
Robert Hagg,22,SWE,PHI,flyers,D,1,0,0,0
Travis Konecny,20,CAN,PHI,flyers,C/LW,70,11,17,28
Scott Laughton,23,CAN,PHI,flyers,C/LW,2,0,0,0
Taylor Leier,23,CAN,PHI,flyers,LW,10,1,1,2
David Pastrnak,21,CZE,BOS,bruins,RW/LW,75,34,36,70
Roman Lyubimov,25,RUS,PHI,flyers,LW,47,4,2,6
Andrew MacDonald,31,CAN,PHI,flyers,D,73,2,16,18
Brandon Manning,27,CAN,PHI,flyers,D,65,3,9,12
Colin McDonald,33,USA,PHI,flyers,RW/C,3,1,0,1
Samuel Morin,22,CAN,PHI,flyers,D,1,0,0,0
Ivan Provorov,20,RUS,PHI,flyers,D,82,6,24,30
Brendan Perlini,21,GBR,ARI,coyotes,LW,57,14,7,21
Michael Raffl,29,AUT,PHI,flyers,LW/C,52,8,3,11
Matt Read,31,CAN,PHI,flyers,RW/LW,63,10,9,19
Corey Perry,32,CAN,ANA,ducks,RW,82,19,34,53
Brayden Schenn,26,CAN,PHI,flyers,C/LW,79,25,30,55
Nick Schultz,35,CAN,PHI,flyers,D,28,0,4,4
Wayne Simmonds,29,CAN,PHI,flyers,RW/LW,82,31,23,54
Chris VandeVelde,30,USA,PHI,flyers,C/LW,81,6,9,15
Mike Vecchione,24,USA,PHI,flyers,C/RW,2,0,0,0
Jakub Voracek,28,CZE,PHI,flyers,RW,82,20,41,61
Jordan Weal,25,CAN,PHI,flyers,C/LW,23,8,4,12
Dale Weise,29,CAN,PHI,flyers,RW,64,8,7,15
Mark Streit,40,CHE,PHI/PIT,flyers,D,68,6,21,27
Valtteri Filppula,33,FIN,PHI/T.B,flyers,C/LW,79,12,30,42
Josh Archibald,25,CAN,PIT,penguins,RW,10,3,0,3
Nick Bonino,29,USA,PIT,penguins,C,80,18,19,37
Ian Cole,28,USA,PIT,penguins,D,81,5,21,26
Sidney Crosby,30,CAN,PIT,penguins,C,75,44,45,89
Matt Cullen,41,USA,PIT,penguins,C/LW,72,13,18,31
Trevor Daley,34,CAN,PIT,penguins,D,56,5,14,19
Jean-Sebastien Dea,23,CAN,PIT,penguins,C,1,0,0,0
Brian Dumoulin,26,USA,PIT,penguins,D,70,1,14,15
Cameron Gaunce,27,CAN,PIT,penguins,D,12,1,3,4
Jake Guentzel,23,USA,PIT,penguins,C/LW,40,16,17,33
Carl Hagelin,29,SWE,PIT,penguins,LW,61,6,16,22
Patric Hornqvist,30,SWE,PIT,penguins,RW,70,21,23,44
Phil Kessel,30,USA,PIT,penguins,RW/C,82,23,47,70
Tom Kuhnhackl,25,DEU,PIT,penguins,RW,57,4,12,16
Teemu Pulkkinen,25,FIN,ARI/MIN,coyotes,LW,13,2,0,2
Chris Kunitz,38,CAN,PIT,penguins,LW,71,9,20,29
Kris Letang,30,CAN,PIT,penguins,D,41,5,29,34
Olli Maatta,23,FIN,PIT,penguins,D,55,1,6,7
Evgeni Malkin,31,RUS,PIT,penguins,C/RW,62,33,39,72
Steve Oleksy,31,USA,PIT,penguins,D,11,0,1,1
Kevin Porter,31,USA,PIT,penguins,C,2,0,0,0
Derrick Pouliot,23,CAN,PIT,penguins,D,11,0,0,0
Carter Rowney,28,CAN,PIT,penguins,RW/C,27,3,4,7
Chad Ruhwedel,27,USA,PIT,penguins,D,34,2,8,10
Rickard Rakell,24,SWE,ANA,ducks,C/RW,71,33,18,51
Bryan Rust,25,USA,PIT,penguins,RW,57,15,13,28
Justin Schultz,27,CAN,PIT,penguins,D,78,12,39,51
Tom Sestito,30,USA,PIT,penguins,LW,13,0,2,2
Conor Sheary,25,USA,PIT,penguins,LW,61,23,30,53
Dominik Simon,23,CZE,PIT,penguins,C,2,0,1,1
Mason Raymond,32,CAN,ANA,ducks,LW,4,0,0,0
Oskar Sundqvist,23,SWE,PIT,penguins,C,10,0,0,0
David Warsofsky,27,USA,PIT,penguins,D,7,0,1,1
Scott Wilson,25,CAN,PIT,penguins,LW/C,78,8,18,26
Frank Corrado,24,CAN,PIT/TOR,penguins,D,4,0,0,0
Eric Fehr,32,CAN,PIT/TOR,penguins,C/RW,53,6,5,11
Mikkel Boedker,28,DNK,S.J,sharks,LW/RW,81,10,16,26
Justin Braun,30,USA,S.J,sharks,D,81,4,9,13
Brent Burns,32,CAN,S.J,sharks,D/RW,82,29,47,76
Ryan Carpenter,26,USA,S.J,sharks,C,11,2,2,4
Brad Richardson,32,CAN,ARI,coyotes,RW/C,16,5,4,9
Tobias Rieder,24,DEU,ARI,coyotes,RW/C,80,16,18,34
Logan Couture,28,CAN,S.J,sharks,C/LW,73,25,27,52
Dylan Demelo,24,CAN,S.J,sharks,D,25,1,7,8
Brenden Dillon,27,CAN,S.J,sharks,D,81,2,8,10
Nick Ritchie,22,CAN,ANA,ducks,LW,77,14,14,28
Joonas Donskoi,25,FIN,S.J,sharks,RW,61,6,11,17
Barclay Goodrow,24,CAN,S.J,sharks,RW/C,3,0,1,1
Micheal Haley,31,CAN,S.J,sharks,C,58,2,10,12
Tim Heed,26,SWE,S.J,sharks,D,1,0,0,0
Tomas Hertl,24,CZE,S.J,sharks,C/RW,49,10,12,22
Melker Karlsson,27,SWE,S.J,sharks,C/RW,67,11,11,22
Kevin Labanc,22,USA,S.J,sharks,RW,55,8,12,20
Patrick Marleau,38,CAN,S.J,sharks,LW/C,82,27,19,46
Paul Martin,36,USA,S.J,sharks,D,81,4,22,26
Timo Meier,21,CHE,S.J,sharks,RW,34,3,3,6
Mirco Mueller,22,CHE,S.J,sharks,D,4,1,1,2
Daniel O'Regan,23,DEU,S.J,sharks,C/LW,3,1,0,1
Joe Pavelski,33,USA,S.J,sharks,C/RW,81,29,39,68
David Schlemko,30,CAN,S.J,sharks,D,62,2,16,18
Marcus Sorensen,25,SWE,S.J,sharks,RW/LW,19,1,3,4
Joe Thornton,38,CAN,S.J,sharks,C,79,7,43,50
Chris Tierney,23,CAN,S.J,sharks,C,80,11,12,23
Marc-Edouard Vlasic,30,CAN,S.J,sharks,D,75,6,22,28
Joel Ward,37,CAN,S.J,sharks,RW/C,78,10,19,29
Nikolay Goldobin,22,RUS,S.J/VAN,sharks,RW/LW,14,3,0,3
Jannik Hansen,31,DNK,S.J/VAN,sharks,RW,43,8,12,20
Kenny Agostino,25,USA,STL,blues,LW,7,1,2,3
Tim Schaller,27,USA,BOS,bruins,C,59,7,7,14
Ivan Barbashev,22,RUS,STL,blues,C,30,5,7,12
Patrik Berglund,29,SWE,STL,blues,C/LW,82,23,11,34
Luke Schenn,28,CAN,ARI,coyotes,D,78,1,7,8
Robert Bortuzzo,28,CAN,STL,blues,D,38,1,3,4
Jay Bouwmeester,34,CAN,STL,blues,D,81,1,14,15
Kyle Brodziak,33,CAN,STL,blues,C,69,8,7,15
Chris Butler,31,USA,STL,blues,D,1,0,0,0
Joel Edmundson,24,CAN,STL,blues,D,69,3,12,15
Robby Fabbri,21,CAN,STL,blues,C/LW,51,11,18,29
Carl Gunnarsson,31,SWE,STL,blues,D,56,0,6,6
Dmitrij Jaskin,24,RUS,STL,blues,RW/LW,51,1,10,11
Jori Lehtera,30,FIN,STL,blues,C,64,7,15,22
Petteri Lindbohm,24,FIN,STL,blues,D,7,0,0,0
Wade Megan,27,USA,STL,blues,C,3,1,0,1
Magnus Paajarvi,26,SWE,STL,blues,LW,32,8,5,13
Colton Parayko,24,CAN,STL,blues,D,81,4,31,35
David Perron,29,CAN,STL,blues,LW/RW,82,18,28,46
Alex Pietrangelo,27,CAN,STL,blues,D,80,14,34,48
Ryan Reaves,30,CAN,STL,blues,RW,80,7,6,13
Jordan Schmaltz,24,USA,STL,blues,D,9,0,2,2
Jaden Schwartz,25,CAN,STL,blues,LW/C,78,19,36,55
Vladimir Sobotka,30,CZE,STL,blues,LW/C,1,1,0,1
Paul Stastny,32,CAN,STL,blues,C,66,18,22,40
Alex Steen,33,CAN,STL,blues,LW/C,76,16,35,51
Michael Sgarbossa,25,CAN,ANA/FLA,ducks,C,38,2,7,9
Vladimir Tarasenko,26,RUS,STL,blues,RW,82,39,36,75
Scottie Upshall,34,CAN,STL,blues,RW/LW,73,10,8,18
Nail Yakupov,24,RUS,STL,blues,RW/LW,40,3,6,9
Logan Shaw,25,CAN,ANA,ducks,C/RW,55,3,7,10
Zach Sanford,23,USA,STL/WSH,blues,LW,39,4,4,8
Kevin Shattenkirk,28,USA,STL/WSH,blues,D,80,13,43,56
Michael Bournival,25,CAN,T.B,lightning,LW,19,2,1,3
J.T. Brown,27,USA,T.B,lightning,RW,64,3,3,6
Ryan Callahan,32,USA,T.B,lightning,RW,18,2,2,4
Braydon Coburn,32,CAN,T.B,lightning,D,80,5,7,12
Cory Conacher,28,CAN,T.B,lightning,C/LW,11,1,3,4
Jakob Silfverberg,27,SWE,ANA,ducks,RW/LW,79,23,26,49
Erik Condra,31,USA,T.B,lightning,RW,13,0,0,0
Jake Dotchin,23,CAN,T.B,lightning,D,35,0,11,11
Jonathan Drouin,22,CAN,T.B,lightning,LW,73,21,32,53
Gabriel Dumont,27,CAN,T.B,lightning,C,39,2,2,4
Adam Erne,22,USA,T.B,lightning,LW,26,3,0,3
Jason Garrison,33,CAN,T.B,lightning,D,70,1,8,9
Yanni Gourde,26,CAN,T.B,lightning,C,20,6,2,8
Victor Hedman,27,SWE,T.B,lightning,D,79,16,56,72
Tyler Johnson,27,USA,T.B,lightning,C,66,19,26,45
Alex Killorn,28,CAN,T.B,lightning,LW/C,81,19,17,36
Slater Koekkoek,23,CAN,T.B,lightning,D,29,0,4,4
Nikita Kucherov,24,RUS,T.B,lightning,RW,74,40,45,85
Vladislav Namestnikov,25,RUS,T.B,lightning,C/LW,74,10,18,28
Ondrej Palat,26,CZE,T.B,lightning,LW,75,17,35,52
Cedric Paquette,24,CAN,T.B,lightning,C/LW,58,4,6,10
Matthew Peca,24,CAN,T.B,lightning,C,10,1,1,2
Brayden Point,21,CAN,T.B,lightning,C,68,18,22,40
Tanner Richard,24,CAN,T.B,lightning,C,3,0,0,0
Steven Stamkos,27,CAN,T.B,lightning,C,17,9,11,20
Anton Stralman,31,SWE,T.B,lightning,D,73,5,17,22
Andrej Sustr,27,CZE,T.B,lightning,D,80,3,11,14
Nick Sorensen,23,DNK,ANA,ducks,RW,5,0,1,1
Joel Vermin,25,CHE,T.B,lightning,RW,18,0,3,3
Luke Witkowski,27,USA,T.B,lightning,D,34,0,4,4
Brian Boyle,33,USA,T.B/TOR,lightning,C/LW,75,13,12,25
Ryan Spooner,25,CAN,BOS,bruins,C/LW,78,12,28,39
Byron Froese,26,CAN,T.B/TOR,lightning,C,6,0,0,0
Tyler Bozak,31,CAN,TOR,mapleleafs,C,78,18,37,55
Connor Brown,23,CAN,TOR,mapleleafs,RW,82,20,16,36
Connor Carrick,23,USA,TOR,mapleleafs,D,67,2,6,8
Jake Gardiner,27,USA,TOR,mapleleafs,D,82,9,34,43
Drew Stafford,32,USA,BOS/WPG,bruins,RW/LW,58,8,13,21
Frederik Gauthier,22,CAN,TOR,mapleleafs,C,21,2,1,3
Matt Hunwick,32,USA,TOR,mapleleafs,D,72,1,18,19
Zach Hyman,25,CAN,TOR,mapleleafs,C/RW/LW,82,10,18,28
Nazem Kadri,27,CAN,TOR,mapleleafs,C,82,32,29,61
Kasperi Kapanen,21,FIN,TOR,mapleleafs,RW,8,1,0,1
Leo Komarov,30,EST,TOR,mapleleafs,C/LW,82,14,18,32
Josh Leivo,24,CAN,TOR,mapleleafs,LW,13,2,8,10
Martin Marincin,25,SVK,TOR,mapleleafs,D,25,1,6,7
Mitchell Marner,20,CAN,TOR,mapleleafs,C/RW,77,19,42,61
Matt Martin,28,CAN,TOR,mapleleafs,LW/RW,82,5,4,9
Auston Matthews,20,USA,TOR,mapleleafs,C,82,40,29,69
Milan Michalek,33,CZE,TOR,mapleleafs,LW/RW,5,1,1,2
Michael Stone,27,CAN,ARI/CGY,coyotes,D,64,3,12,15
Clayton Stoner,32,CAN,ANA,ducks,D,14,1,2,3
William Nylander,21,CAN,TOR,mapleleafs,C/RW,81,22,39,61
Roman Polak,31,CZE,TOR,mapleleafs,D,75,4,7,11
Morgan Rielly,23,CAN,TOR,mapleleafs,D,76,6,21,27
Nikita Soshnikov,24,RUS,TOR,mapleleafs,RW,56,5,4,9
Dylan Strome,20,CAN,ARI,coyotes,C,7,0,1,1
James van Riemsdyk,28,USA,TOR,mapleleafs,LW,82,29,33,62
Nikita Zaitsev,26,RUS,TOR,mapleleafs,D,82,4,32,36
Sven Baertschi,25,CHE,VAN,canucks,LW,68,18,17,35
Alex Biega,29,CAN,VAN,canucks,D,36,0,3,3
Brock Boeser,20,USA,VAN,canucks,RW,9,4,1,5
Michael Chaput,25,CAN,VAN,canucks,C,68,4,5,9
Derek Dorsett,31,CAN,VAN,canucks,RW,14,1,3,4
Alex Edler,31,SWE,VAN,canucks,D,68,6,15,21
Loui Eriksson,32,SWE,VAN,canucks,LW/C,65,11,13,24
Brendan Gaunce,23,CAN,VAN,canucks,C/LW,57,0,5,5
Markus Granlund,24,FIN,VAN,canucks,C,69,19,13,32
Alex Grenier,26,CAN,VAN,canucks,RW,3,0,0,0
Erik Gudbranson,25,CAN,VAN,canucks,D,30,1,5,6
Bo Horvat,22,CAN,VAN,canucks,C,81,20,32,52
Ben Hutton,24,CAN,VAN,canucks,D,71,5,14,19
Joseph Labate,24,USA,VAN,canucks,C,13,0,0,0
Shea Theodore,22,CAN,ANA,ducks,D,34,2,7,9
Nate Thompson,33,USA,ANA,ducks,C,30,1,1,2
Philip Larsen,28,DNK,VAN,canucks,D,26,1,5,6
Evan McEneny,23,CAN,VAN,canucks,D,1,0,0,0
Jayson Megna,27,USA,VAN,canucks,C,58,4,4,8
Griffen Molino,23,USA,VAN,canucks,C,5,0,0,0
Borna Rendulic,25,HRV,VAN,canucks,RW/C,1,0,0,0
Anton Rodin,27,SWE,VAN,canucks,RW,3,0,1,1
Luca Sbisa,27,ITA,VAN,canucks,D,82,2,11,13
Daniel Sedin,37,SWE,VAN,canucks,LW,82,15,29,44
Henrik Sedin,37,SWE,VAN,canucks,C,82,15,35,50
Drew Shore,26,USA,VAN,canucks,C,14,0,2,2
Jack Skille,30,USA,VAN,canucks,RW,55,5,4,9
Troy Stecher,23,CAN,VAN,canucks,D,71,3,21,24
Corey Tropp,28,USA,ANA,ducks,RW/LW,1,0,0,0
Brandon Sutter,28,USA,VAN,canucks,C,81,17,17,34
Chris Tanev,28,CAN,VAN,canucks,D,53,2,8,10
Nikita Tryamkin,23,RUS,VAN,canucks,D,66,2,7,9
Jake Virtanen,21,CAN,VAN,canucks,RW,10,0,1,1
Michael Zalewski,25,USA,VAN,canucks,LW/C,1,0,0,0
Joel Armia,24,FIN,WPG,jets,RW,57,10,9,19
Dustin Byfuglien,32,USA,WPG,jets,D/RW,80,13,39,52
Ben Chiarot,26,CAN,WPG,jets,D,59,2,10,12
Kyle Connor,21,USA,WPG,jets,LW,20,2,3,5
Andrew Copp,23,USA,WPG,jets,C,64,9,8,17
Marko Dano,23,AUT,WPG,jets,C/LW/RW,38,4,7,11
Nikolaj Ehlers,21,DNK,WPG,jets,LW,82,25,39,64
Sami Vatanen,26,FIN,ANA,ducks,D,71,3,21,24
Frank Vatrano,23,USA,BOS,bruins,C/LW,44,10,8,18
Tobias Enstrom,33,SWE,WPG,jets,D,60,1,13,14
Antoine Vermette,35,CAN,ANA,ducks,C/LW,72,9,19,28
Quinton Howden,25,CAN,WPG,jets,C/LW/C,5,0,0,0
Patrik Laine,19,FIN,WPG,jets,RW,73,36,28,64
Bryan Little,30,CAN,WPG,jets,C/RW,59,21,26,47
Adam Lowry,24,USA,WPG,jets,C/LW,82,15,14,29
Shawn Matthias,29,CAN,WPG,jets,LW/C,45,8,4,12
Julian Melchiori,26,CAN,WPG,jets,D,18,0,2,2
Josh Morrissey,22,CAN,WPG,jets,D,82,6,14,20
Tyler Myers,27,USA,WPG,jets,D,11,2,3,5
Radim Vrbata,36,CZE,ARI,coyotes,RW,81,20,35,55
Chris Wagner,26,USA,ANA,ducks,C/RW,43,6,1,7
Nelson Nogier,21,CAN,WPG,jets,D,10,0,0,0
Mathieu Perreault,29,CAN,WPG,jets,C/LW,65,13,32,45
Nic Petan,22,CAN,WPG,jets,LW/C,54,1,12,13
Paul Postma,28,CAN,WPG,jets,D,65,1,13,14
Jack Roslovic,20,USA,WPG,jets,C,1,0,0,0
Mark Scheifele,24,CAN,WPG,jets,C,79,32,50,82
Brian Strait,29,USA,WPG,jets,D,5,0,2,2
Mark Stuart,33,USA,WPG,jets,D,42,2,2,4
Brandon Tanev,26,CAN,WPG,jets,LW/C/RW,51,2,2,4
Chris Thorburn,34,CAN,WPG,jets,RW/LW,64,3,1,4
Jacob Trouba,23,USA,WPG,jets,D,60,8,25,33
Blake Wheeler,31,USA,WPG,jets,RW,82,26,48,74
Karl Alzner,29,CAN,WSH,capitals,D,82,3,10,13
Ryan White,29,CAN,ARI/MIN,coyotes,C,65,9,7,16
Nicklas Backstrom,30,SWE,WSH,capitals,C,82,23,63,86
Riley Barber,23,USA,WSH,capitals,RW,3,0,0,0
Jay Beagle,32,CAN,WSH,capitals,C/RW,81,13,17,30
Andre Burakovsky,22,AUT,WSH,capitals,LW/C,64,12,23,35
Paul Carey,29,USA,WSH,capitals,C,6,0,0,0
John Carlson,27,USA,WSH,capitals,D,72,9,28,37
Taylor Chorney,30,CAN,WSH,capitals,D,18,1,4,5
Brett Connolly,25,CAN,WSH,capitals,RW/LW,66,15,8,23
Lars Eller,28,DNK,WSH,capitals,C/LW/RW,81,12,13,25
Marcus Johansson,27,SWE,WSH,capitals,LW/C/RW,82,24,34,58
Evgeny Kuznetsov,25,RUS,WSH,capitals,C/LW,82,19,40,59
Garrett Mitchell,26,CAN,WSH,capitals,RW,1,0,0,0
Aaron Ness,27,USA,WSH,capitals,D,2,0,0,0
Matt Niskanen,31,USA,WSH,capitals,D,78,5,34,39
Liam O'Brien,23,CAN,WSH,capitals,C/LW,1,0,0,0
Dmitry Orlov,26,RUS,WSH,capitals,D,82,6,27,33
Brooks Orpik,37,USA,WSH,capitals,D,79,0,14,14
T.J. Oshie,31,USA,WSH,capitals,RW/C,68,33,23,56
Alex Ovechkin,32,RUS,WSH,capitals,LW/RW,82,33,36,69
Nate Schmidt,26,USA,WSH,capitals,D,60,3,14,17
Chandler Stephenson,23,CAN,WSH,capitals,C,4,0,0,0
Jakub Vrana,21,CZE,WSH,capitals,LW,21,3,3,6
Justin Williams,36,CAN,WSH,capitals,RW,80,24,24,48
Tom Wilson,23,CAN,WSH,capitals,RW,82,7,12,19
Daniel Winnik,32,CAN,WSH,capitals,LW/C,72,12,13,25
